F 34,139,34
C 135,206,235

NO textures/wolfenstein/red_brick.xpm
SO textures/wolfenstein/blue_stone.xpm
WE textures/wolfenstein/wood.xpm
EA textures/wolfenstein/purple_stone.xpm

1111111111111111111
1000000000000000001
1011111110111111101
1010000010000000101
1010111010111010101
100010001N000010001
1010111011101110101
1010000000000000101
1011111111111111101
1000000000000000001
1111111111111111111