NO textures/wall_3.xpm
SO textures/wall_4.xpm
WE textures/purplestone.xpm
EA textures/floor_1.xpm
F 105,105,105  # Bunker floor color (Dim Gray)
C 169,169,169  # Ceiling color (Dark Gray)

111111111111111
100000000000001
101111011110101
101000000000001
101111011111111
100W00000000001
111111011111101
100000000000001
101111011111101
100000000000001
111111111111111
