NO textures/sky_1.xpm
SO textures/eagle.xpm
WE textures/bluestone.xpm
EA textures/wall_1.xpm
F 255,255,255  # Castle floor color (White)
C 70,130,180  # Sky color (Steel Blue)

11111111111111111
10000000000000001
10111101111110101
10000000000000001
11111101110111111
10000000000000001
11111101111110101
10000000000000001
10111101110111111
100000N0000000001
11111111111111111
