NO textures/wall_1.xpm
SO textures/wall_1.xpm
WE textures/wall_1.xpm
EA textures/wall_1.xpm
F 139,69,19  # Castle floor color (Brown)
C 128,128,128  # Ceiling color (Gray)

111111111111111
100000000000001
101110111011101
10001E001000101
111011101110111
100000000000001
101110111011101
100010001000001
101111111011111
100000000000001
111111111111111
