NO textures/pillar.xpm
SO textures/purplestone.xpm
WE textures/wood.xpm
EA textures/bluestone.xpm
F 210,180,140  # Desert floor color (Tan)
C 255,255,224  # Ceiling color (Light Yellow)

1111111111111111
1000000W00000001
1011100000111001
1000000000000011
1011100000111011
1000000000000001
1011100000111011
1010101010101011
1011100000000011
1000000000000001
1111111111111111
